00000000000000
XX000000000000
XXXX0000000000
XXXXXX00000000
XXXXXXXX000000
XXXXXXXXXX0000
XXXXXXXXXXXX00
SSSSSSSSSSSSSXX